 ------------------------------------------------------------------- 
|XXXXXXXXXXXXXXXXXXXXXXXXXXXXXXXXXXXXXXXXXXXXXXXXXXXXXXXXXXXXXXXXXXX|
|XXXXXXXXXXXXXXXXXXXXXXXXXXXXXXXXXXXXXXXXXXXXXXXXXXXXXXXXXXXXXXXXXXX|
|                    XX                             $  XX      XXXXX|
|   $   XX           XX    XXXXXXXXXXXXXXXXXXXXXXXXXXXXXX      XXXXX|
|       XX           XX                                        XXXXX|
|XXXXXXXXX           XXXXXXXXXXXXXXXXXXXXXXXXXXXXXXXXXXXX      XXXXX|
|                    XX                                XX      XXXXX|
|                    XX                     __         XX           |
|                                          (((         XX      XXXXX|
|      XXXXXXXXXXXXXXXX                                XX      XXXXX|
|      X             XX                                XX      XXXXX|
|      X     XX      XXXXXXXXXXXXXXXXXXXXXXXXXXXXXXXXXXXX      XXXXX|
|      X     XX                                                XXXXX|
|            XXXXXXXXXXXXXXXXXXXXXXXXXXXXXXXXXXXXXXXXXXXXXXXXXXXXXXX|
|                                                     $  XXXXXXXXXXX|
 ------------------------------------------------------------------- 

