 ------------------------------------------------------------------- 
|XXXXXXXXXXXXXXXXXXXXXXXXXXXXXXXXXXXXXXXXXXXXXXXXXXXXXXXXXXXXXXXXXXX|
|XXXXXXXXXXXXXXXXXXXXXXXXXXXXXXXXXXXXXXXXXXXXXXXXXXXXXXXXXXXXXXXXXXX|
|                    XX                            $   XXXXXXXXXXXXX|
|  $    XX           XX    XXXXXXXXXXXXXXXXXXXXXXXXXXXXX            |
|       XX                                                          |
|XXXXXXXXX           XXXXXXXXXXXXXXXXXXXXXXXXXXXXXXXXXXXXXX         |
|                    XX      $                     $   XXXX         |
| $                  XX             $                  XXXX         |
|XXXXXXXXXXXXXXXXXXXXXXXXXXXXXXXXXXXXXXXXXXXXXXXXXXXXXXXXXX XXXXXXXX|
|XXXXXXXXXXXXXXXXXXXXXXXXXXXXXXXXXXXXXXXXXXXXXXXXXXXXXXXXXX  XXXXXXX|
|  __  X             XXXXXXXXXXXXXXXXXXXXXXXXXXXXXXXXXXXXXX    XXXXX|
| (((  X     XX      XXXXXXXXXXXXXXXXXXXXXXXXXXXXXXXXXXXX       XXXX|
|      X     XX                                                 XXXX|
|            XX                                                 XXXX|
|            XX                                                 XXXX|
 ------------------------------------------------------------------- 

